6,6
 , , , , ,D
 ,S, , , , 
 , , ,m, , 
 , , ,G, , 
 , , , , , 
 , , , , , 
